#,#,#,#,#,#,#,#,#,#,#,#,#,#,#,
#,#,#,#,#,#,#,#,#,#,#,#,#,#,#,
#,#,#,#,#,#,#,#,#,#,#,#,#,#,#,
r,s,s,s,s,s,s,s,r,s,s,s,s,s,s,
s,s,s,s,s,s,r,r,r,s,s,s,s,s,s,
r,r,s,s,r,s,s,s,s,s,s,s,s,s,s,
r,r,s,r,r,r,s,s,s,s,s,s,s,s,s,
s,s,s,s,r,s,s,s,s,s,s,s,s,s,s,
s,s,s,s,s,s,s,s,s,s,s,s,s,s,s,
s,s,s,s,s,s,s,s,s,s,s,s,s,s,s,
s,s,s,s,s,s,s,s,s,s,s,s,s,s,s,
s,s,s,s,s,s,s,s,s,s,s,s,s,s,s,
s,s,s,s,s,s,s,s,s,s,s,s,s,s,s,
s,s,s,s,s,s,s,s,s,s,s,s,s,s,s,
s,s,s,s,s,s,s,s,s,s,s,s,s,s,s,
s,s,s,s,s,s,s,s,s,s,s,s,s,s,s,
s,s,s,s,s,s,s,s,s,s,s,s,s,s,s,
s,s,s,s,s,s,s,s,s,s,s,s,s,s,s,
